NO ./img/so.xpm
SO ./img/wall3.xpm
WE ./img/wall1.xpm
EA ./img/no.xpm
C 136, 8, 8
F 128,126,120

111111111111111111111111111111111
100000000011000000000000111111111
10110000011100000000000011111111
100100000000000000000000111111111
111111111011000001110000000000001
100000000011000001110111111111111
11110111111111011100000010001
11110111111111011101010000001
11000000110101011100000000001
10000000000000001100000010001
10000000000000001101010010001
11000001110101011111011110N0111
11110111 1110101 101111010001
11111111 1111111 111111111111
